{
  "by_index": {
    "3699": " ",
    "3714": "!",
    "3728": "\"",
    "2275": "#",
    "3719": "$",
    "2271": "%",
    "3718": "&",
    "3717": "'",
    "3721": "(",
    "3722": ")",
    "3723": "*",
    "3725": "+",
    "3711": ",",
    "3724": "-",
    "3710": ".",
    "3720": "/",
    "3700": "0",
    "3701": "1",
    "3702": "2",
    "3703": "3",
    "3704": "4",
    "3705": "5",
    "3706": "6",
    "3707": "7",
    "3708": "8",
    "3709": "9",
    "3712": ":",
    "3713": ";",
    "2241": "<",
    "3726": "=",
    "2242": ">",
    "3715": "?",
    "2273": "@",
    "3501": "A",
    "3502110": "B",
    "3503": "C",
    "3504": "D",
    "3505": "E",
    "3506": "F",
    "3507": "G",
    "3508112": "H",
    "3509": "I",
    "3510": "J",
    "3511115": "K",
    "3512": "L",
    "3513107": "M",
    "3514": "N",
    "3515": "O",
    "3516": "P",
    "3517": "Q",
    "3518108": "R",
    "3519": "S",
    "3520": "T",
    "3521": "U",
    "3522": "V",
    "3523": "W",
    "3524": "X",
    "3525": "Y",
    "3526": "Z",
    "2223": "[",
    "804": "\\",
    "2224": "]",
    "2262": "^",
    "999": "_",
    "3716": "`",
    "3601": "a",
    "3602": "b",
    "3603": "c",
    "3604": "d",
    "3605": "e",
    "3606": "f",
    "3607": "g",
    "3608": "h",
    "3609": "i",
    "3610": "j",
    "3611": "k",
    "3612": "l",
    "3613": "m",
    "3614": "n",
    "3615": "o",
    "3616": "p",
    "3617": "q",
    "3618": "r",
    "3619": "s",
    "3620": "t",
    "3621": "u",
    "3622": "v",
    "3623": "w",
    "3624": "x",
    "3625": "y",
    "3626": "z",
    "2225": "{",
    "2229": "|",
    "2226": "}",
    "2246": "~"
  }
}