{
  "by_index": {
    "3699": " ",
    "3714": "!",
    "3728": "\"",
    "2275": "#",
    "3719": "$",
    "2271": "%",
    "3718": "&",
    "3717": "'",
    "3721": "(",
    "3722": ")",
    "3723": "*",
    "3725": "+",
    "3711": ",",
    "3724": "-",
    "3710": ".",
    "3720": "/",
    "3700": "0",
    "3701": "1",
    "3702": "2",
    "3703": "3",
    "3704": "4",
    "3705": "5",
    "3706": "6",
    "3707": "7",
    "3708": "8",
    "3709": "9",
    "3712": ":",
    "3713": ";",
    "2241": "<",
    "3726": "=",
    "2242": ">",
    "3715": "?",
    "2273": "@",
    "3801": "A",
    "3802": "B",
    "3803": "C",
    "3804": "D",
    "3805": "E",
    "3806": "F",
    "3807": "G",
    "3808": "H",
    "3809": "I",
    "3810": "J",
    "3811": "K",
    "3812": "L",
    "3813": "M",
    "3814": "N",
    "3815": "O",
    "3816": "P",
    "3817": "Q",
    "3818": "R",
    "3819": "S",
    "3820": "T",
    "3821": "U",
    "3822": "V",
    "3823": "W",
    "3824": "X",
    "3825": "Y",
    "3826": "Z",
    "2223": "[",
    "804": "\\",
    "2224": "]",
    "2262": "^",
    "999": "_",
    "3716": "`",
    "3901": "a",
    "3902": "b",
    "3903": "c",
    "3904": "d",
    "3905": "e",
    "3906": "f",
    "3907": "g",
    "3908": "h",
    "3909": "i",
    "3910": "j",
    "3911": "k",
    "3912": "l",
    "3913": "m",
    "3914": "n",
    "3915": "o",
    "3916": "p",
    "3917": "q",
    "3918": "r",
    "3919": "s",
    "3920": "t",
    "3921": "u",
    "3922": "v",
    "3923": "w",
    "3924": "x",
    "3925": "y",
    "3926": "z",
    "2225": "{",
    "2229": "|",
    "2226": "}",
    "2246": "~"
  }
}