{
  "by_index": {
    "3699": " ",
    "3714": "!",
    "3728": "\"",
    "2275": "#",
    "3719": "$",
    "2271": "%",
    "3718": "&",
    "3717": "'",
    "3721": "(",
    "3722": ")",
    "3723": "*",
    "3725": "+",
    "3711": ",",
    "3724": "-",
    "3710": ".",
    "3720": "/",
    "3700": "0",
    "3701": "1",
    "3702": "2",
    "3703": "3",
    "3704": "4",
    "3705": "5",
    "3706": "6",
    "3707": "7",
    "3708": "8",
    "3709": "9",
    "3712": ":",
    "3713": ";",
    "2241": "<",
    "3726": "=",
    "2242": ">",
    "3715": "?",
    "2273": "@",
    "3301": "A",
    "3302101": "B",
    "3303": "C",
    "3304": "D",
    "3305": "E",
    "3306": "F",
    "3307": "G",
    "3308": "H",
    "3309": "I",
    "3310": "J",
    "3311": "K",
    "3312": "L",
    "3313128": "M",
    "3314": "N",
    "3315": "O",
    "3316100": "P",
    "3317": "Q",
    "3318": "R",
    "3319": "S",
    "3320": "T",
    "3321": "U",
    "3322100": "V",
    "3323143": "W",
    "3324": "X",
    "3325": "Y",
    "3326": "Z",
    "2223": "[",
    "804": "\\",
    "2224": "]",
    "2262": "^",
    "999": "_",
    "3716": "`",
    "3401": "a",
    "3402": "b",
    "3403": "c",
    "3404": "d",
    "3405": "e",
    "3406": "f",
    "3407": "g",
    "3408": "h",
    "3409": "i",
    "3410": "j",
    "3411": "k",
    "3412": "l",
    "3413": "m",
    "3414": "n",
    "3415": "o",
    "3416": "p",
    "3417": "q",
    "3418": "r",
    "3419": "s",
    "3420": "t",
    "3421": "u",
    "3422": "v",
    "3423": "w",
    "3424": "x",
    "3425": "y",
    "3426": "z",
    "2225": "{",
    "2229": "|",
    "2226": "}",
    "2246": "~"
  }
}