{
  "by_index": {
    "2199": "z",
    "2214": "!",
    "2213": ";",
    "2275": "#",
    "2274": "$",
    "2271": "%",
    "2272": "&",
    "2251": "'",
    "2221": "(",
    "2222": ")",
    "2219": "*",
    "2232": "+",
    "2211": ",",
    "2231": "-",
    "2210": ".",
    "2220": "/",
    "2200": "0",
    "2201": "1",
    "2202": "2",
    "2203": "3",
    "2204": "4",
    "2205": "5",
    "2206": "6",
    "2207": "7",
    "2208": "8",
    "2209": "9",
    "2212": ":",
    "2241": "<",
    "2238": "=",
    "2242": ">",
    "2215": "?",
    "2273": "@",
    "2027": "A",
    "2028": "B",
    "2029": "C",
    "2030": "D",
    "2031": "E",
    "2032": "F",
    "2033": "G",
    "2034": "H",
    "2035": "I",
    "2036": "J",
    "2037": "K",
    "2038": "L",
    "2039": "M",
    "2040": "N",
    "2041": "O",
    "2042": "P",
    "2043": "Q",
    "2044": "R",
    "2045": "S",
    "2046": "T",
    "2047": "U",
    "2048": "V",
    "2049": "W",
    "2050": "X",
    "2223": "[",
    "804": "\\",
    "2224": "]",
    "2262": "^",
    "999": "_",
    "2252": "`",
    "2127": "a",
    "2128": "b",
    "2129": "c",
    "2130": "d",
    "2131": "e",
    "2132": "f",
    "2133": "g",
    "2134": "h",
    "2135": "i",
    "2136": "j",
    "2137": "k",
    "2138": "l",
    "2139": "m",
    "2140": "n",
    "2141": "o",
    "2142": "p",
    "2143": "q",
    "2144": "r",
    "2145": "s",
    "2146": "t",
    "2147": "u",
    "2148": "v",
    "2149": "w",
    "2150": "x",
    "2225": "{",
    "2229": "|",
    "2226": "}",
    "2246": "~"
  }
}