{
  "by_index": {
    "699": "z",
    "714": "!",
    "717": "\"",
    "733": "#",
    "719": "$",
    "2271": "%",
    "734": "&",
    "731": "'",
    "721": "(",
    "722": ")",
    "2219": "*",
    "725": "+",
    "711": ",",
    "724": "-",
    "710": ".",
    "720": "/",
    "700": "0",
    "701": "1",
    "702": "2",
    "703": "3",
    "704": "4",
    "705": "5",
    "706": "6",
    "707": "7",
    "708": "8",
    "709": "9",
    "712": ":",
    "713": ";",
    "2241": "<",
    "726": "=",
    "2242": ">",
    "715": "?",
    "2273": "@",
    "527": "A",
    "528": "B",
    "529": "C",
    "530": "D",
    "531": "E",
    "532": "F",
    "533": "G",
    "534": "H",
    "535": "I",
    "536": "J",
    "537": "K",
    "538": "L",
    "539": "M",
    "540": "N",
    "541": "O",
    "542": "P",
    "543": "Q",
    "544": "R",
    "545": "S",
    "546": "T",
    "547": "U",
    "548": "V",
    "549": "W",
    "550": "X",
    "2223": "[",
    "804": "\\",
    "2224": "]",
    "2262": "^",
    "999": "_",
    "730": "`",
    "627": "a",
    "628": "b",
    "629": "c",
    "630": "d",
    "631": "e",
    "632": "f",
    "633": "g",
    "634": "h",
    "635": "i",
    "636": "j",
    "637": "k",
    "638": "l",
    "639": "m",
    "640": "n",
    "641": "o",
    "642": "p",
    "643": "q",
    "644": "r",
    "645": "s",
    "646": "t",
    "647": "u",
    "648": "v",
    "649": "w",
    "650": "x",
    "2225": "{",
    "723": "|",
    "2226": "}",
    "2246": "~"
  }
}