{
  "by_index": {
    "3199": " ",
    "3214": "!",
    "3228": "\"",
    "2275": "#",
    "3219": "$",
    "2271": "%",
    "3218": "&",
    "3217": "'",
    "3221": "(",
    "3222": ")",
    "3223": "*",
    "3225": "+",
    "3211": ",",
    "3224": "-",
    "3210": ".",
    "3220": "/",
    "3200": "0",
    "3201": "1",
    "3202": "2",
    "3203": "3",
    "3204": "4",
    "3205": "5",
    "3206": "6",
    "3207": "7",
    "3208": "8",
    "3209": "9",
    "3212": ":",
    "3213": ";",
    "2241": "<",
    "3226": "=",
    "2242": ">",
    "3215": "?",
    "2273": "@",
    "3001": "A",
    "3002": "B",
    "3003": "C",
    "3004": "D",
    "3005": "E",
    "3006": "F",
    "3007": "G",
    "3008": "H",
    "3009": "I",
    "3010": "J",
    "3011": "K",
    "3012": "L",
    "3013": "M",
    "3014": "N",
    "3015": "O",
    "3016": "P",
    "3017": "Q",
    "3018": "R",
    "3019": "S",
    "3020": "T",
    "3021": "U",
    "3022": "V",
    "3023": "W",
    "3024": "X",
    "3025": "Y",
    "3026": "Z",
    "2223": "[",
    "804": "\\",
    "2224": "]",
    "2262": "^",
    "999": "_",
    "3216": "`",
    "3101": "a",
    "3102": "b",
    "3103": "c",
    "3104": "d",
    "3105": "e",
    "3106": "f",
    "3107": "g",
    "3108": "h",
    "3109": "i",
    "3110": "j",
    "3111": "k",
    "3112": "l",
    "3113": "m",
    "3114": "n",
    "3115": "o",
    "3116": "p",
    "3117": "q",
    "3118": "r",
    "3119": "s",
    "3120": "t",
    "3121": "u",
    "3122": "v",
    "3123": "w",
    "3124": "x",
    "3125": "y",
    "3126": "z",
    "2225": "{",
    "2229": "|",
    "2226": "}",
    "2246": "~"
  }
}