{
  "by_index": {
    "699": " ",
    "714": "!",
    "717": "\"",
    "733": "#",
    "719": "$",
    "2271": "%",
    "734": "&",
    "731": "'",
    "721": "(",
    "722": ")",
    "2219": "*",
    "725": "+",
    "711": ",",
    "724": "-",
    "710": ".",
    "720": "/",
    "700": "0",
    "701": "1",
    "702": "2",
    "703": "3",
    "704": "4",
    "705": "5",
    "706": "6",
    "707": "7",
    "708": "8",
    "709": "9",
    "712": ":",
    "713": ";",
    "2241": "<",
    "726": "=",
    "2242": ">",
    "715": "?",
    "2273": "@",
    "501": "A",
    "502": "B",
    "503": "C",
    "504": "D",
    "505": "E",
    "506": "F",
    "507": "G",
    "508": "H",
    "509": "I",
    "510": "J",
    "511": "K",
    "512": "L",
    "513": "M",
    "514": "N",
    "515": "O",
    "516": "P",
    "517": "Q",
    "518": "R",
    "519": "S",
    "520": "T",
    "521": "U",
    "522": "V",
    "523": "W",
    "524": "X",
    "525": "Y",
    "526": "Z",
    "2223": "[",
    "804": "\\",
    "2224": "]",
    "2262": "^",
    "999": "_",
    "730": "`",
    "601": "a",
    "602": "b",
    "603": "c",
    "604": "d",
    "605": "e",
    "606": "f",
    "607": "g",
    "608": "h",
    "609": "i",
    "610": "j",
    "611": "k",
    "612": "l",
    "613": "m",
    "614": "n",
    "615": "o",
    "616": "p",
    "617": "q",
    "618": "r",
    "619": "s",
    "620": "t",
    "621": "u",
    "622": "v",
    "623": "w",
    "624": "x",
    "625": "y",
    "626": "z",
    "2225": "{",
    "723": "|",
    "2226": "}",
    "2246": "~"
  }
}