{
  "by_index": {
    "2699": " ",
    "2714": "!",
    "2728": "\"",
    "2275": "#",
    "2719": "$",
    "2271": "%",
    "2718": "&",
    "2717": "'",
    "2721": "(",
    "2722": ")",
    "2723": "*",
    "2725": "+",
    "2711": ",",
    "2724": "-",
    "2710": ".",
    "2720": "/",
    "2700": "0",
    "2701": "1",
    "2702": "2",
    "2703": "3",
    "2704": "4",
    "2705": "5",
    "2706": "6",
    "2707": "7",
    "2708": "8",
    "2709": "9",
    "2712": ":",
    "2713": ";",
    "2241": "<",
    "2726": "=",
    "2242": ">",
    "2715": "?",
    "2273": "@",
    "2501": "A",
    "2502": "B",
    "2503": "C",
    "2504": "D",
    "2505": "E",
    "2506": "F",
    "2507": "G",
    "2508": "H",
    "2509": "I",
    "2510": "J",
    "2511": "K",
    "2512": "L",
    "2513": "M",
    "2514": "N",
    "2515": "O",
    "2516": "P",
    "2517": "Q",
    "2518": "R",
    "2519": "S",
    "2520": "T",
    "2521": "U",
    "2522": "V",
    "2523": "W",
    "2524": "X",
    "2525": "Y",
    "2526": "Z",
    "2223": "[",
    "804": "\\",
    "2224": "]",
    "2262": "^",
    "999": "_",
    "2716": "`",
    "2601": "a",
    "2602": "b",
    "2603": "c",
    "2604": "d",
    "2605": "e",
    "2606": "f",
    "2607": "g",
    "2608": "h",
    "2609": "i",
    "2610": "j",
    "2611": "k",
    "2612": "l",
    "2613": "m",
    "2614": "n",
    "2615": "o",
    "2616": "p",
    "2617": "q",
    "2618": "r",
    "2619": "s",
    "2620": "t",
    "2621": "u",
    "2622": "v",
    "2623": "w",
    "2624": "x",
    "2625": "y",
    "2626": "z",
    "2225": "{",
    "2229": "|",
    "2226": "}",
    "2246": "~"
  }
}