{
  "by_index": {
    "699": " ",
    "2764": "!",
    "2778": "\"",
    "733": "#",
    "2769": "$",
    "2271": "%",
    "2768": "&",
    "2767": "'",
    "2771": "(",
    "2772": ")",
    "2773": "*",
    "725": "+",
    "2761": ",",
    "724": "-",
    "710": ".",
    "2770": "/",
    "2750": "0",
    "2751": "1",
    "2752": "2",
    "2753": "3",
    "2754": "4",
    "2755": "5",
    "2756": "6",
    "2757": "7",
    "2758": "8",
    "2759": "9",
    "2762": ":",
    "2763": ";",
    "2241": "<",
    "726": "=",
    "2242": ">",
    "2765": "?",
    "2273": "@",
    "551": "A",
    "552": "B",
    "553": "C",
    "554": "D",
    "555": "E",
    "556": "F",
    "557": "G",
    "558": "H",
    "559": "I",
    "560": "J",
    "561": "K",
    "562": "L",
    "563": "M",
    "564": "N",
    "565": "O",
    "566": "P",
    "567": "Q",
    "568": "R",
    "569": "S",
    "570": "T",
    "571": "U",
    "572": "V",
    "573": "W",
    "574": "X",
    "575": "Y",
    "576": "Z",
    "2223": "[",
    "804": "\\",
    "2224": "]",
    "2262": "^",
    "999": "_",
    "2766": "`",
    "651": "a",
    "652": "b",
    "653": "c",
    "654": "d",
    "655": "e",
    "656": "f",
    "657": "g",
    "658": "h",
    "659": "i",
    "660": "j",
    "661": "k",
    "662": "l",
    "663": "m",
    "664": "n",
    "665": "o",
    "666": "p",
    "667": "q",
    "668": "r",
    "669": "s",
    "670": "t",
    "671": "u",
    "672": "v",
    "673": "w",
    "674": "x",
    "675": "y",
    "676": "z",
    "2225": "{",
    "723": "|",
    "2226": "}",
    "2246": "~"
  }
}